[en]

14=Edit
15=Do you really want delete this item?
16=Delete
19=Quote
1=Please, enter comment bellow! Thanks.
20=Spam
23=Username
24=Password
25={author_nick} wrote
26=Read {comm_count} comment(s) on this article
2=Post it
8=comments disabled
9=Please, login to comment
ago=ago
agoLong= minute, minutes, hour, hours, day, days
agoShort= min., mins., h., h., day, days
and=
apply=Apply
badlogin=Bad username or password
bonus=Bonus
categories=Categories
category=Category
clear=Clear
comments=Comments
date=Date
empty=No comments yet. Be the first to post one!
filterBy=Filter by
freerolls=Freerolls
live_search=Live Search
min_dep=Min. Deposit
more_freerolls=More Freerolls
next=Next
now=&lt; 1 min.
pages=Pages
points=Points req.
pokerStrategy=Poker Strategy
prev=Previous
prize_pool=Prize Pool
qualification=Qualification Period
room=Room
share=Share It
shareFacebook=Share this on Facebook
shareThis=Share this
spotlight=Spotlight
subscribeFeed=Subscribe to feed
tags=Tags
tweet=Tweet this
whatdoyouThink=What do you think?
jokes=Poker Jokes
bonuscode=Bonus Code
marketingcode=Marketing Code
wrote=wrote
bestPromotion=Best Promotions
liveCoverage=Live coverage
page=Page

registerforComment=<a href="{!link:page|signup}">Register</a> to leave a comment or <a href="{url.facebook}">login with facebook</a>
postToWall=Post this comment to my facebook wall